chrom,junction_start,junction_stop,strand,unique_junction_reads,multimap_junction_reads,reads
chr10,128491034,128491719,+,21,0,21
chr10,128491034,128491719,-,5,0,5
chr10,128491034,128492058,+,20,137,157
chr10,128491765,128492058,+,21,0,21
chr10,128491765,128492058,-,2,0,2
chr10,128492137,128492228,+,132,13,145
chr10,128492137,128492228,-,77,34,111
chr10,128492260,128492260,+,1,0,1
chr10,128492362,128492362,-,1,0,1
chr10,128492403,128492601,+,113,6,119
chr10,128492403,128492601,-,179,5,184
chr10,128492616,128492616,+,1,0,1
chr10,128492746,128493538,+,69,0,69
chr10,128492746,128493538,-,147,1,148
chr10,128493567,128493808,+,40,0,40
chr10,128493567,128493808,-,157,1,158
chr10,128493832,128493832,-,1,0,1
chr10,128496397,128496613,-,1,0,1
chr10,128496642,128497200,-,1,0,1
chr10,128499527,128502408,+,1,0,1
chr10,128499527,128502408,-,1,0,1
chr10,128501690,128502408,+,2,0,2
chr14,24490759,24491749,+,37,34,71
chr14,24490759,24491749,-,12,15,27
chr14,24491816,24491906,+,50,0,50
chr14,24491816,24491906,-,34,3,37
chr14,24492117,24493382,+,69,1,70
chr14,24492117,24493382,-,51,1,52
chr14,24493494,24494051,-,1,0,1
chr14,24493494,24495429,+,9,1,10
chr14,24493494,24495429,-,40,3,43
chr14,24495450,24495774,+,6,0,6
chr14,24495450,24495774,-,23,0,23
chr14,64123354,64210262,+,11,0,11
chr14,64123354,64210262,-,9,0,9
chr14,64123354,64210427,+,17,4,21
chr14,64123354,64210427,-,20,2,22
chr14,64123354,64233828,+,2,0,2
chr14,64123354,64233828,-,2,0,2
chr14,64210535,64233828,+,34,0,34
chr14,64210535,64233828,-,22,0,22
chr14,64233934,64257283,+,7,0,7
chr14,64233934,64257283,-,27,0,27
chr14,64233934,64285063,+,8,0,8
chr14,64233934,64285063,-,18,0,18
chr14,64233934,64417081,+,1,0,1
chr14,64233934,64417081,-,10,0,10
chr14,64285184,64313686,+,17,0,17
chr14,64285184,64313686,-,25,0,25
chr14,64313756,64416897,-,23,0,23
chr14,64313756,64417081,+,7,0,7
chr14,64313756,64417081,-,13,0,13
chr16,84827996,84828424,+,436,11,447
chr16,84827996,84828424,-,196,17,213
chr16,84828444,84828444,-,1,0,1
chr16,84828550,84831328,+,519,0,519
chr16,84828550,84831328,-,371,0,371
chr16,84831393,84831394,-,1,0,1
chr16,84831500,84831501,-,1,0,1
chr16,84831503,84834808,+,15,0,15
chr16,84831503,84834808,-,55,0,55
chr16,84831508,84833819,+,23,0,23
chr16,84831508,84833819,-,54,1,55
chr16,84831508,84834808,+,85,0,85
chr16,84831508,84834808,-,411,0,411
chr16,84833835,84833835,-,1,0,1
chr16,84833875,84834808,+,18,0,18
chr16,84833875,84834808,-,71,0,71
chr17,80201603,80202168,+,20,0,20
chr17,80201603,80202168,-,21,0,21
chr17,80202205,80202690,+,16,0,16
chr17,80202205,80202690,-,29,0,29
chr17,80202745,80204121,+,11,0,11
chr17,80202745,80204121,-,23,0,23
chr17,80202745,80204130,+,3,0,3
chr17,80202745,80204130,-,11,0,11
chr17,80204233,80204312,+,39,0,39
chr17,80204233,80204312,-,20,0,20
chr17,80204388,80205261,+,20,0,20
chr17,80204388,80205261,-,18,0,18
chr17,80205439,80205847,+,29,0,29
chr17,80205439,80205847,-,21,0,21
chr17,80206029,80207174,+,30,0,30
chr17,80206029,80207174,-,38,0,38
chr2,136713601,136756067,+,925,53,978
chr2,136713601,136756067,-,451,1,452
chr2,136713784,136756067,+,33,0,33
chr2,136713784,136756067,-,4,0,4
chr2,136756099,136756099,+,1,0,1
chr2,136756107,136756107,+,1,0,1
chr2,136756202,136758310,+,1212,38,1250
chr2,136756202,136758310,-,737,24,761
chr2,136758318,136758318,+,1,0,1
chr2,136758324,136758324,+,1,0,1
chr2,136758353,136763572,+,999,96,1095
chr2,136758353,136763572,-,904,28,932
chr2,136763576,136763576,+,2,0,2
chr2,136763584,136763584,-,1,0,1
chr2,136763622,136769742,+,396,53,449
chr2,136763622,136769742,-,269,16,285
chr2,136763622,136770056,+,638,53,691
chr2,136763622,136770056,-,572,16,588
chr2,136769861,136773894,+,443,44,487
chr2,136769861,136773894,-,306,45,351
chr2,136770080,136770080,-,1,0,1
chr2,136770136,136770136,+,1,0,1
chr2,136770153,136770153,+,1,0,1
chr2,136770155,136770156,-,1,0,1
chr2,136770175,136773894,+,585,44,629
chr2,136770175,136773894,-,489,43,532
chr2,136773917,136773917,+,12,4,16
chr2,136773917,136773917,-,7,4,11
chr2,136773927,136773927,+,1,0,1
chr2,136773971,136773973,+,1,0,1
chr2,136773976,136773976,-,1,0,1
chr2,136773994,136773994,-,1,0,1
chr2,136774021,136777335,+,1172,6,1178
chr2,136774021,136777335,-,1016,3,1019
chr2,136777356,136777356,+,3,0,3
chr2,136777393,136777395,+,1,0,1
chr2,136777393,136777395,-,1,0,1
chr2,136777481,136781074,+,1165,0,1165
chr2,136777481,136781074,-,765,0,765
chr2,136781106,136781106,+,1,0,1
chr5,125387302,125387757,+,2,142,144
chr5,125387355,125387810,+,2,4,6
chr5,125387530,125387757,+,3,3,6
chr5,125388265,125389696,+,105,0,105
chr5,125388265,125389696,-,519,0,519
chr5,125389703,125389703,+,1,0,1
chr7,126487491,126487587,+,23,1,24
chr7,126487491,126487587,-,9,0,9
chr7,126487783,126488259,+,26,1,27
chr7,126487783,126488259,-,11,0,11
chr7,126488427,126488649,+,38,1,39
chr7,126488427,126488649,-,14,0,14
chr7,126488755,126488836,+,31,0,31
chr7,126488755,126488836,-,31,3,34
chr7,126489002,126489119,+,32,0,32
chr7,126489002,126489119,-,44,0,44
chr7,126489253,126489335,+,60,2,62
chr7,126489253,126489335,-,41,2,43
chr7,126489375,126489375,+,1,0,1
chr7,126489375,126489375,-,1,0,1
chr7,126489441,126489551,+,46,1,47
chr7,126489441,126489551,-,42,2,44
chr7,126489704,126489791,+,20,0,20
chr7,126489704,126489791,-,31,0,31
chr7,126489912,126490320,+,27,1,28
chr7,126489912,126490320,-,46,1,47
chr9,67024566,67031028,+,5,0,5
chr9,67024566,67031028,-,4,0,4
chr9,67031099,67031451,+,14,0,14
chr9,67031099,67031451,-,3,0,3
chr9,67031515,67031950,+,18,0,18
chr9,67031515,67031950,-,5,0,5
chr9,67032027,67032793,+,9,0,9
chr9,67032027,67032793,-,10,0,10
chr9,67032865,67033875,+,3,0,3
chr9,67032865,67033875,-,6,0,6
chr9,67033994,67035994,+,4,0,4
chr9,67033994,67035994,-,8,0,8
chr9,67036129,67043577,+,3,0,3
chr9,67036129,67043577,-,9,0,9
